images/maps/groundTextures.png
xx,xx xx,xx xx,xx xx,xx xx,xx xx,xx xx,xx xx,xx xx,xx xx,xx n0,02 n0,02 xx,xx xx,xx xx,xx xx,xx xx,xx xx,xx xx,xx xx,xx xx,xx xx,xx xx,xx xx,xx xx,xx xx,xx
xx,xx 00,00 00,00 00,00 00,00 00,00 00,00 00,00 00,00 00,00 03,00 04,00 00,00 00,00 00,00 00,00 00,00 00,00 00,00 00,00 00,00 00,00 00,00 00,00 00,00 xx,xx
xx,xx 00,00 00,00 00,00 00,00 00,00 00,00 00,00 00,00 00,00 03,00 04,00 00,00 00,00 00,00 00,00 00,00 00,00 00,00 00,00 00,00 00,00 00,00 00,00 00,00 xx,xx
xx,xx 00,00 00,00 00,00 00,00 00,00 00,00 00,00 00,00 00,00 03,00 04,00 00,00 00,00 00,00 00,00 00,00 00,00 00,00 00,00 00,00 00,00 00,00 00,00 00,00 xx,xx
xx,xx 00,00 00,00 00,00 00,00 00,00 00,00 00,00 00,00 00,00 03,00 04,00 00,00 00,00 00,00 00,00 00,00 00,00 00,00 00,00 00,00 00,00 00,00 00,00 00,00 xx,xx
xx,xx 00,00 00,00 00,00 00,00 00,00 00,00 00,00 00,00 00,00 03,00 02,01 03,02 00,00 00,00 00,00 00,00 00,00 00,00 00,00 00,00 00,00 00,00 00,00 00,00 xx,xx
xx,xx 00,00 00,00 00,00 00,00 00,00 00,00 00,00 00,00 00,00 02,02 03,01 04,00 00,00 00,00 00,00 00,00 00,00 00,00 00,00 00,00 00,00 00,00 00,00 00,00 xx,xx
xx,xx 00,00 00,00 00,00 00,00 00,00 00,00 00,00 00,00 00,00 00,00 06,02 07,02 00,00 00,00 00,00 00,00 00,00 00,00 00,00 00,00 00,00 00,00 00,00 00,00 xx,xx
xx,xx 00,00 00,00 00,00 00,00 00,00 00,00 00,00 00,00 00,00 00,00 06,02 07,02 00,00 00,00 00,00 00,00 00,00 00,00 00,00 00,00 00,00 00,00 00,00 00,00 xx,xx
xx,xx 00,00 00,00 00,00 00,00 00,00 00,00 00,00 00,00 00,00 00,00 03,00 04,00 00,00 00,00 00,00 00,00 00,00 00,00 00,00 00,00 00,00 00,00 00,00 00,00 xx,xx
xx,xx 00,00 00,00 00,00 00,00 00,00 00,00 00,00 00,00 00,00 00,00 03,00 02,01 01,00 01,00 01,00 01,00 01,00 01,00 01,00 01,00 01,00 01,00 01,00 01,00 01,00
xx,xx 00,00 00,00 00,00 00,00 00,00 00,00 00,00 00,00 00,00 00,00 03,00 04,01 02,00 02,00 02,00 02,00 02,00 02,00 02,00 02,00 02,00 02,00 02,00 02,00 02,00
xx,xx 00,00 00,00 00,00 00,00 00,00 00,00 00,00 00,00 00,00 00,00 03,00 04,00 00,00 00,00 00,00 00,00 00,00 00,00 00,00 00,00 00,00 00,00 00,00 00,00 xx,xx
xx,xx 00,00 00,00 00,00 00,00 00,00 00,00 00,00 00,00 00,00 00,00 03,00 04,00 00,00 00,00 00,00 00,00 00,00 00,00 00,00 00,00 00,00 00,00 00,00 00,00 xx,xx
xx,xx 00,00 00,00 04,02 01,00 01,00 01,00 01,00 01,00 01,00 01,00 01,01 04,00 00,00 00,00 00,00 00,00 00,00 00,00 00,00 00,00 00,00 00,00 00,00 00,00 xx,xx
n0,01 01,00 01,00 01,01 04,01 02,00 02,00 02,00 02,00 02,00 03,01 04,01 01,02 00,00 00,00 00,00 00,00 00,00 00,00 00,00 00,00 00,00 00,00 00,00 00,00 xx,xx
n0,01 02,00 02,00 02,00 01,02 00,00 00,00 00,00 00,00 00,00 03,00 04,00 00,00 00,00 00,00 00,00 00,00 00,00 00,00 00,00 00,00 00,00 00,00 00,00 00,00 xx,xx
xx,xx 00,00 00,00 00,00 00,00 00,00 00,00 00,00 00,00 00,00 03,00 04,00 00,00 00,00 00,00 00,00 00,00 00,00 00,00 00,00 00,00 00,00 00,00 00,00 00,00 xx,xx
xx,xx 00,00 00,00 00,00 00,00 00,00 00,00 00,00 00,00 00,00 03,00 04,00 00,00 00,00 00,00 00,00 00,00 00,00 00,00 00,00 00,00 00,00 00,00 00,00 00,00 xx,xx
xx,xx 00,00 00,00 00,00 00,00 00,00 00,00 00,00 00,00 00,00 03,00 04,00 00,00 00,00 00,00 00,00 00,00 00,00 00,00 00,00 00,00 00,00 00,00 00,00 00,00 xx,xx
xx,xx 00,00 00,00 00,00 00,00 00,00 00,00 00,00 00,00 00,00 03,00 04,00 00,00 00,00 00,00 00,00 00,00 00,00 00,00 00,00 00,00 00,00 00,00 00,00 00,00 xx,xx
xx,xx 00,00 00,00 00,00 00,00 00,00 00,00 00,00 00,00 00,00 03,00 04,00 00,00 00,00 00,00 00,00 00,00 00,00 00,00 00,00 00,00 00,00 00,00 00,00 00,00 xx,xx
xx,xx 00,00 00,00 00,00 00,00 00,00 00,00 00,00 00,00 00,00 03,00 04,00 00,00 00,00 00,00 00,00 00,00 00,00 00,00 00,00 00,00 00,00 00,00 00,00 00,00 xx,xx
xx,xx 00,00 00,00 00,00 00,00 00,00 00,00 00,00 00,00 00,00 03,00 04,00 00,00 00,00 00,00 00,00 00,00 00,00 00,00 00,00 00,00 00,00 00,00 00,00 00,00 xx,xx
xx,xx 00,00 00,00 00,00 00,00 00,00 00,00 00,00 00,00 00,00 03,00 04,00 00,00 00,00 00,00 00,00 00,00 00,00 00,00 00,00 00,00 00,00 00,00 00,00 00,00 xx,xx
xx,xx 00,00 00,00 00,00 00,00 00,00 00,00 00,00 00,00 00,00 03,00 04,00 00,00 00,00 00,00 00,00 00,00 00,00 00,00 00,00 00,00 00,00 00,00 00,00 00,00 xx,xx
xx,xx 00,00 00,00 00,00 00,00 00,00 00,00 00,00 00,00 00,00 03,00 04,00 00,00 00,00 00,00 00,00 00,00 00,00 00,00 00,00 00,00 00,00 00,00 00,00 00,00 xx,xx
xx,xx 00,00 00,00 00,00 00,00 00,00 00,00 00,00 00,00 00,00 03,00 04,00 00,00 00,00 00,00 00,00 00,00 00,00 00,00 00,00 00,00 00,00 00,00 00,00 00,00 xx,xx
xx,xx 00,00 00,00 00,00 00,00 00,00 00,00 00,00 00,00 00,00 03,00 04,00 00,00 00,00 00,00 00,00 00,00 00,00 00,00 00,00 00,00 00,00 00,00 00,00 00,00 xx,xx
xx,xx 00,00 00,00 00,00 00,00 00,00 00,00 00,00 00,00 00,00 03,00 04,00 00,00 00,00 00,00 00,00 00,00 00,00 00,00 00,00 00,00 00,00 00,00 00,00 00,00 xx,xx
xx,xx xx,xx xx,xx xx,xx xx,xx xx,xx xx,xx xx,xx xx,xx xx,xx 03,00 04,00 xx,xx xx,xx xx,xx xx,xx xx,xx xx,xx xx,xx xx,xx xx,xx xx,xx xx,xx xx,xx xx,xx xx,xx
