images/maps/wallTextures.png
xx,xx 00,00 00,00 00,00 00,00 00,00 00,00 00,00 00,00 00,00 00,00 00,00 00,00 00,00 00,00 00,00 00,00 00,00 00,00 xx,xx
xx,xx 00,00 xx,xx xx,xx xx,xx xx,xx xx,xx xx,xx xx,xx xx,xx xx,xx xx,xx xx,xx xx,xx xx,xx xx,xx xx,xx xx,xx 00,00 xx,xx
xx,xx 00,00 xx,xx xx,xx xx,xx xx,xx xx,xx xx,xx xx,xx xx,xx xx,xx xx,xx xx,xx xx,xx xx,xx xx,xx xx,xx xx,xx 00,00 xx,xx
xx,xx 00,00 xx,xx xx,xx xx,xx xx,xx xx,xx xx,xx xx,xx xx,xx xx,xx xx,xx xx,xx xx,xx xx,xx xx,xx xx,xx xx,xx 00,00 xx,xx
xx,xx 00,00 xx,xx xx,xx xx,xx xx,xx xx,xx xx,xx xx,xx xx,xx xx,xx xx,xx xx,xx xx,xx xx,xx xx,xx xx,xx xx,xx 00,00 xx,xx
xx,xx 00,00 xx,xx xx,xx xx,xx xx,xx xx,xx xx,xx xx,xx xx,xx xx,xx xx,xx xx,xx xx,xx xx,xx xx,xx xx,xx xx,xx 00,00 xx,xx
xx,xx 00,00 xx,xx xx,xx xx,xx xx,xx xx,xx xx,xx xx,xx xx,xx xx,xx xx,xx xx,xx xx,xx xx,xx xx,xx xx,xx xx,xx xx,xx xx,xx
xx,xx 00,00 xx,xx xx,xx xx,xx xx,xx xx,xx xx,xx xx,xx xx,xx xx,xx xx,xx xx,xx xx,xx xx,xx xx,xx xx,xx xx,xx xx,xx xx,xx
xx,xx 00,00 xx,xx xx,xx xx,xx xx,xx xx,xx xx,xx xx,xx xx,xx xx,xx xx,xx xx,xx xx,xx xx,xx xx,xx xx,xx xx,xx 00,00 xx,xx
xx,xx 00,00 xx,xx xx,xx xx,xx xx,xx xx,xx xx,xx xx,xx xx,xx xx,xx xx,xx xx,xx xx,xx xx,xx xx,xx xx,xx xx,xx 00,00 xx,xx
xx,xx 00,00 xx,xx xx,xx xx,xx xx,xx xx,xx xx,xx xx,xx xx,xx xx,xx xx,xx xx,xx xx,xx xx,xx xx,xx xx,xx xx,xx 00,00 xx,xx
xx,xx 00,00 xx,xx xx,xx xx,xx xx,xx xx,xx xx,xx xx,xx xx,xx xx,xx xx,xx xx,xx xx,xx xx,xx xx,xx xx,xx xx,xx 00,00 xx,xx
xx,xx 00,00 xx,xx xx,xx xx,xx xx,xx xx,xx xx,xx xx,xx xx,xx xx,xx xx,xx xx,xx xx,xx xx,xx xx,xx xx,xx xx,xx 00,00 xx,xx
xx,xx xx,xx xx,xx xx,xx xx,xx xx,xx xx,xx xx,xx xx,xx xx,xx xx,xx xx,xx xx,xx xx,xx xx,xx xx,xx xx,xx xx,xx 00,00 xx,xx
xx,xx xx,xx xx,xx xx,xx xx,xx xx,xx xx,xx xx,xx xx,xx xx,xx xx,xx xx,xx xx,xx xx,xx xx,xx xx,xx xx,xx xx,xx 00,00 xx,xx
xx,xx 00,00 xx,xx xx,xx xx,xx xx,xx xx,xx xx,xx xx,xx xx,xx xx,xx xx,xx xx,xx xx,xx xx,xx xx,xx xx,xx xx,xx 00,00 xx,xx
xx,xx 00,00 xx,xx xx,xx xx,xx xx,xx xx,xx xx,xx xx,xx xx,xx xx,xx xx,xx xx,xx xx,xx xx,xx xx,xx xx,xx xx,xx 00,00 xx,xx
xx,xx 00,00 xx,xx xx,xx xx,xx xx,xx xx,xx xx,xx xx,xx xx,xx xx,xx xx,xx xx,xx xx,xx xx,xx xx,xx xx,xx xx,xx 00,00 xx,xx
xx,xx 00,00 xx,xx xx,xx xx,xx xx,xx xx,xx xx,xx xx,xx xx,xx xx,xx xx,xx xx,xx xx,xx xx,xx xx,xx xx,xx xx,xx 00,00 xx,xx
xx,xx 00,00 xx,xx xx,xx xx,xx xx,xx xx,xx xx,xx xx,xx xx,xx xx,xx xx,xx xx,xx xx,xx xx,xx xx,xx xx,xx xx,xx 00,00 xx,xx
xx,xx 00,00 xx,xx xx,xx xx,xx xx,xx xx,xx xx,xx xx,xx xx,xx xx,xx xx,xx xx,xx xx,xx xx,xx xx,xx xx,xx xx,xx 00,00 xx,xx
xx,xx 00,00 xx,xx xx,xx xx,xx xx,xx xx,xx xx,xx xx,xx xx,xx xx,xx xx,xx xx,xx xx,xx xx,xx xx,xx xx,xx xx,xx 00,00 xx,xx
xx,xx 00,00 xx,xx xx,xx xx,xx xx,xx xx,xx xx,xx xx,xx xx,xx xx,xx xx,xx xx,xx xx,xx xx,xx xx,xx xx,xx xx,xx 00,00 xx,xx
xx,xx 00,00 00,00 00,00 00,00 00,00 00,00 00,00 00,00 00,00 00,00 00,00 00,00 00,00 00,00 00,00 00,00 00,00 00,00 xx,xx
